####################
#                  #
#                  #
#          @    @  #
#      @           #
#@                 #
#         @        #
####################