XXXXXXXXXXXXXXX
X             X
X             X
X  ####  I    X
X             X
X         ##  X
X             X
X             X
X      ####   X
X             X
X    B        X
X      M      X
X   R     ### X
X             X
XXXXXXXXXXXXXXX