#######################
#      ===            #
#        ===          #
#      =   == @    @  #
#      @  ===         #
#@    =  =   =        #
#    =   =  @    =    #
#######################