XXXXXXXXXXXXXXX
X  #     ###  X
X X#  X       X
X# #### X     X
X  X #X       X
X X   #   ##X X
X   XXXXX     X
XXXXX///XXXXXXX